[
  "1111110111111001111011000", 
  "1101111001011010110101111", 
  "0001101111110001111111011", 
  "1111111110011110011100000", 
  "1111101101110011110111111", 
  "0111001110111101111111101", 
  "1111111111111111011011110", 
  "1110011110011110010100011", 
  "0000101111111111111100011", 
  "1001110011110111111011100", 
  "0011001110111111111101110", 
  "1100011110111101111110011", 
  "0011100111011110111101100", 
  "0110011110111110110101111", 
  "0111000110111111110100111", 
  "0011101111111101111000011", 
  "0011100111000110000100111", 
  "0111001111011111100111111", 
  "1111011111110010110111111", 
  "0011011110100111110100110", 
  "1111110111101101101101111",
  "0110001111000010111101111", 
  "0101101111011010001100011", 
  "1111110111111010000111111", 
  "0110011100101100111001110", 
  "0001011110110111100111111", 
  "1111111111110011000110011", 
  "1111011111111111001110011", 
  "1101010110101111111111011", 
  "0011001111110011100101111", 
  "1110110111111100110011100", 
  "1111111111111100010000100", 
  "0011000111111111111100111", 
  "1101111110110000110011100",
  "1100011110110100101001110", 
  "0000000011001111110111100", 
  "0111101111011001111111110", 
  "0001101111110111111010000", 
  "0111101011010101111111111", 
  "0111100111001110001100000", 
  "1100010000110001100111111", 
  "0011101101111101011111111", 
  "0111001110011110111100000", 
  "0111001011110011000100001", 
  "0000011000110111111110111", 
  "0011100011000111110100111", 
  "1111110011011100110000000", 
  "1111110111001111000111111", 
  "1111010011000111111010000", 
  "1111011110111101100011000" 
  ]