[
    "001100110011000111111",
    "011110000111100001111",
    "000111000111000111000",
    "001001001001001001001",
    "010101010101010101010",
    "011001100110011001100",
    "100010001000100010001",
    "110011001100110011001",
    "101010101010101010101",
    "111000111000111000111"
  ]